#################
#       #       #
# # ### # ### # #
#     # # #     #
### #       # ###
  # #### #### #  
  # #       # #  
###   ## ##   ###
    # #   # #    
### # ##### # ###
  #           #  
### # ##### # ###
#   #  ###  #   #
# # ##     ## # #
# #    ###    # #
#   ##  A  ##   #
#################